1111111111111111111111111111111111
1E00000000000000000000000000000001
1010010100100000101001000000010001
1010010010101010001001000000010001
10P000000C010100000000000000000001
1000000000000000000000000000000001
10C0000000000000000000000010000001
1000000000000100000000000000000001
100000000000000000000000000C000001
1111111111111111111111111111111111