1111111111111111111111
1P000000000000000001C1
10000000000000000001C1
1111100000000001111111
10C0000000000000000001
1000000000000000000E01
1111111111111111111111